Symbol	Name	Gene Family	Type	RNA-Seq Correlation	RNA-Seq Correlation Self-Rank
INSIG1	insulin induced gene 1		landmark		
FOXO3	forkhead box O3	Forkhead boxes	landmark		
CDH3	cadherin 3	Type I classical cadherins	landmark		
ORC1	origin recognition complex subunit 1	AAA ATPases, Origin recognition complex 	landmark		
ITGAE	integrin subunit alpha E	CD molecules, Integrin alpha subunits	landmark		
CDK7	cyclin dependent kinase 7	Cyclin dependent kinases	landmark		
FOS	Fos proto-oncogene, AP-1 transcription factor subunit	Basic leucine zipper proteins, Fos transcription factor family	landmark		
CDK6	cyclin dependent kinase 6	Cyclin dependent kinases	landmark		
CDK4	cyclin dependent kinase 4	Cyclin dependent kinases	landmark		
CDK2	cyclin dependent kinase 2	Cyclin dependent kinases	landmark		
ITGB5	integrin subunit beta 5	Integrin beta subunits	landmark		
CDKN2A	cyclin dependent kinase inhibitor 2A		landmark		
CDKN1B	cyclin dependent kinase inhibitor 1B		landmark		
CDKN1A	cyclin dependent kinase inhibitor 1A		landmark		
FPGS	folylpolyglutamate synthase		landmark		
CEBPD	CCAAT/enhancer binding protein delta	Basic leucine zipper proteins, CCAAT/enhancer binding proteins 	landmark		
CEBPA	CCAAT/enhancer binding protein alpha	Basic leucine zipper proteins, CCAAT/enhancer binding proteins 	landmark		
CENPE	centromere protein E	Kinesins, Protein phosphatase 1 regulatory subunits	landmark		
MICALL1	MICAL like 1	LIM domain containing	landmark		
CETN3	centrin 3	EF-hand domain containing	landmark		
UBE2C	ubiquitin conjugating enzyme E2 C	Ubiquitin conjugating enzymes E2	landmark		
DUSP14	dual specificity phosphatase 14	Atypical dual specificity phosphatases	landmark		
TOPBP1	topoisomerase (DNA) II binding protein 1	BRCA1 B complex	landmark		
B4GAT1	beta-1,4-glucuronyltransferase 1		landmark		
RBM34	RNA binding motif protein 34	RNA binding motif containing	landmark		
PAPD7	poly(A) RNA polymerase D7, non-canonical	Non-canonical poly(A) polymerases	landmark		
WDTC1	WD and tetratricopeptide repeats 1	WD repeat domain containing, DDB1 and CUL4 associated factors, Tetratricopeptide repeat domain containing	landmark		
XPO7	exportin 7	Exportins	landmark		
AKAP8L	A-kinase anchoring protein 8 like		landmark		
RAB31	RAB31, member RAS oncogene family	RAB, member RAS oncogene GTPases	landmark		
SPEN	spen family transcriptional repressor	RNA binding motif containing	landmark		
FBXO21	F-box protein 21	F-boxes other	landmark		
RAB21	RAB21, member RAS oncogene family	RAB, member RAS oncogene GTPases	landmark		
SLC27A3	solute carrier family 27 member 3	Acyl-CoA synthetase family, Solute carriers	landmark		
KIF2C	kinesin family member 2C	Kinesins	landmark		
CCDC85B	coiled-coil domain containing 85B		landmark		
TLK2	tousled like kinase 2		landmark		
KDELR2	KDEL endoplasmic reticulum protein retention receptor 2		landmark		
MCUR1	mitochondrial calcium uniporter regulator 1		landmark		
CDK19	cyclin dependent kinase 19	Cyclin dependent kinases, Mediator complex	landmark		
JUN	Jun proto-oncogene, AP-1 transcription factor subunit	Basic leucine zipper proteins, Jun transcription factor family	landmark		
TBC1D9B	TBC1 domain family member 9B	EF-hand domain containing, GRAM domain containing	landmark		
PRSS23	protease, serine 23	Proteases, serine	landmark		
RRP1B	ribosomal RNA processing 1B	Protein phosphatase 1 regulatory subunits	landmark		
MYCBP2	MYC binding protein 2, E3 ubiquitin protein ligase		landmark		
CHEK1	checkpoint kinase 1		landmark		
KCNK1	potassium two pore domain channel subfamily K member 1	Potassium two pore domain channel subfamily K	landmark		
CHN1	chimerin 1	Rho GTPase activating proteins, SH2 domain containing	landmark		
CIRBP	cold inducible RNA binding protein	RNA binding motif containing	landmark		
HDGFRP3	hepatoma-derived growth factor, related protein 3		landmark		
COPS7A	COP9 signalosome subunit 7A	COP9 signalosome	landmark		
NSDHL	NAD(P) dependent steroid dehydrogenase-like	Short chain dehydrogenase/reductase superfamily	landmark		
ATP11B	ATPase phospholipid transporting 11B (putative)	ATPase phospholipid transporting	landmark		
PRAF2	PRA1 domain family member 2	YIP family	landmark		
JMJD6	arginine demethylase and lysine hydroxylase		landmark		
RRS1	ribosome biogenesis regulator homolog		landmark		
MPC2	mitochondrial pyruvate carrier 2		landmark		
ARID5B	AT-rich interaction domain 5B	AT-rich interaction domain containing	landmark		
POLG2	DNA polymerase gamma 2, accessory subunit	DNA polymerases	landmark		
CHEK2	checkpoint kinase 2		landmark		
BACE2	beta-site APP-cleaving enzyme 2		landmark		
COG4	component of oligomeric golgi complex 4	Components of oligomeric golgi complex	landmark		
SPDEF	SAM pointed domain containing ETS transcription factor	ETS transcription factor family	landmark		
BAMBI	BMP and activin membrane bound inhibitor		landmark		
SPRED2	sprouty related EVH1 domain containing 2		landmark		
SLC2A6	solute carrier family 2 member 6	Solute carriers	landmark		
SNX13	sorting nexin 13	Sorting nexins	landmark		
NISCH	nischarin		landmark		
AARS	alanyl-tRNA synthetase	Aminoacyl tRNA synthetases, Class II	landmark		
ABCF1	ATP binding cassette subfamily F member 1	ATP binding cassette subfamily F	landmark		
ABL1	ABL proto-oncogene 1, non-receptor tyrosine kinase	SH2 domain containing	landmark		
FCHO1	FCH domain only 1	F-BAR domain containing	landmark		
DCUN1D4	defective in cullin neddylation 1 domain containing 4		landmark		
PSIP1	PC4 and SFRS1 interacting protein 1	PWWP domain containing	landmark		
ACAA1	acetyl-CoA acyltransferase 1		landmark		
ACAT2	acetyl-CoA acetyltransferase 2		landmark		
ACLY	ATP citrate lyase		landmark		
PKIG	cAMP-dependent protein kinase inhibitor gamma		landmark		
CORO1A	coronin 1A	WD repeat domain containing, Coronins	landmark		
MAST2	microtubule associated serine/threonine kinase 2	PDZ domain containing	landmark		
GPATCH8	G-patch domain containing 8	G-patch domain containing	landmark		
FBXO7	F-box protein 7	F-boxes other, Parkinson disease associated genes	landmark		
LSM6	LSM6 homolog, U6 small nuclear RNA and mRNA degradation associated		landmark		
PWP1	PWP1 homolog, endonuclein	WD repeat domain containing	landmark		
KIF5C	kinesin family member 5C	Kinesins	landmark		
KIT	KIT proto-oncogene receptor tyrosine kinase	Receptor Tyrosine Kinases, CD molecules, Immunoglobulin like domain containing	landmark		
FUT1	fucosyltransferase 1 (H blood group)	Fucosyltransferases, Blood group antigens	landmark		
FYN	FYN proto-oncogene, Src family tyrosine kinase	SH2 domain containing, Src family tyrosine kinases	landmark		
GAA	glucosidase alpha, acid		landmark		
CLTC	clathrin heavy chain		landmark		
CLTB	clathrin light chain B		landmark		
SLC37A4	solute carrier family 37 member 4	Solute carriers	landmark		
GABPB1	GA binding protein transcription factor beta subunit 1	Ankyrin repeat domain containing	landmark		
KTN1	kinectin 1		landmark		
GALE	UDP-galactose-4-epimerase	Short chain dehydrogenase/reductase superfamily	landmark		
GAPDH	glyceraldehyde-3-phosphate dehydrogenase		landmark		
COL4A1	collagen type IV alpha 1 chain	Collagens	landmark		
COL1A1	collagen type I alpha 1 chain	Collagens	landmark		
TRIM2	tripartite motif containing 2	Ring finger proteins, Tripartite motif containing	landmark		
TSKU	tsukushi, small leucine rich proteoglycan		landmark		
WASHC4	WASH complex subunit 4	WASH complex	landmark		
USP22	ubiquitin specific peptidase 22	Ubiquitin specific peptidases, SAGA complex	landmark		
HDAC6	histone deacetylase 6	Protein phosphatase 1 regulatory subunits, Histone deacetylases, class IIB	landmark		
TWF2	twinfilin actin binding protein 2		landmark		
WDR7	WD repeat domain 7	WD repeat domain containing	landmark		
JADE2	jade family PHD finger 2	PHD finger proteins	landmark		
ATMIN	ATM interactor	Zinc fingers C2H2-type	landmark		
C2CD2	C2 calcium dependent domain containing 2	C2 domain containing	landmark		
DDX42	DEAD-box helicase 42	DEAD-box helicases	landmark		
TIPARP	TCDD inducible poly(ADP-ribose) polymerase	Poly(ADP-ribose) polymerases	landmark		
GNPDA1	glucosamine-6-phosphate deaminase 1		landmark		
ECD	ecdysoneless cell cycle regulator		landmark		
CLIC4	chloride intracellular channel 4	Chloride intracellular channels	landmark		
PNKP	polynucleotide kinase 3'-phosphatase	HAD Asp-based non-protein phosphatases	landmark		
CAMSAP2	calmodulin regulated spectrin associated protein family member 2		landmark		
CHP1	calcineurin like EF-hand protein 1	EF-hand domain containing	landmark		
PDS5A	PDS5 cohesin associated factor A		landmark		
RRP12	ribosomal RNA processing 12 homolog		landmark		
SYNE2	spectrin repeat containing nuclear envelope protein 2	Spectrin repeat containing nuclear envelope family	landmark		
LAMA3	laminin subunit alpha 3	Laminin subunits	landmark		
STMN1	stathmin 1	Stathmins	landmark		
LBR	lamin B receptor	Tudor domain containing	landmark		
HEBP1	heme binding protein 1	Endogenous ligands	landmark		
GATA3	GATA binding protein 3	GATA zinc finger domain containing	landmark		
GATA2	GATA binding protein 2	GATA zinc finger domain containing	landmark		
LGALS8	galectin 8	Galectins	landmark		
LIG1	DNA ligase 1	DNA ligases, Nucleotide excision repair	landmark		
LIPA	lipase A, lysosomal acid type	Lipases	landmark		
GFPT1	glutamine--fructose-6-phosphate transaminase 1		landmark		
GHR	growth hormone receptor	Fibronectin type III domain containing	landmark		
CREB1	cAMP responsive element binding protein 1	Basic leucine zipper proteins	landmark		
RPL39L	ribosomal protein L39 like	L ribosomal proteins	landmark		
CRKL	CRK like proto-oncogene, adaptor protein	SH2 domain containing	landmark		
CRK	CRK proto-oncogene, adaptor protein	SH2 domain containing	landmark		
SLC35A3	solute carrier family 35 member A3	Solute carriers	landmark		
TRAP1	TNF receptor associated protein 1	Heat shock 90kDa proteins	landmark		
G3BP1	G3BP stress granule assembly factor 1	RNA binding motif containing	landmark		
KIF20A	kinesin family member 20A	Kinesins	landmark		
ARL4C	ADP ribosylation factor like GTPase 4C	ARF GTPase family	landmark		
SIRT3	sirtuin 3	Sirtuins	landmark		
TSPAN3	tetraspanin 3	Tetraspanins	landmark		
NUDCD3	NudC domain containing 3	NudC family	landmark		
SMC4	structural maintenance of chromosomes 4	Structural maintenance of chromosomes proteins	landmark		
ARHGEF12	Rho guanine nucleotide exchange factor 12	Rho guanine nucleotide exchange factors, PDZ domain containing	landmark		
PPP1R13B	protein phosphatase 1 regulatory subunit 13B	Ankyrin repeat domain containing, Protein phosphatase 1 regulatory subunits	landmark		
ABCC5	ATP binding cassette subfamily C member 5	ATP binding cassette subfamily C	landmark		
DNM1L	dynamin 1 like		landmark		
ABCB6	ATP binding cassette subfamily B member 6 (Langereis blood group)	Blood group antigens, ATP binding cassette subfamily B	landmark		
RRP8	ribosomal RNA processing 8, methyltransferase, homolog (yeast)	Seven-beta-strand methyltransferase motif containing	landmark		
PARP2	poly(ADP-ribose) polymerase 2	Poly(ADP-ribose) polymerases	landmark		
MAMLD1	mastermind like domain containing 1		landmark		
DNAJB6	DnaJ heat shock protein family (Hsp40) member B6	DNAJ (HSP40) heat shock proteins	landmark		
GLI2	GLI family zinc finger 2	Zinc fingers C2H2-type	landmark		
GLRX	glutaredoxin		landmark		
CRYZ	crystallin zeta		landmark		
GNAI2	G protein subunit alpha i2		landmark		
GNAI1	G protein subunit alpha i1		landmark		
GNA11	G protein subunit alpha 11		landmark		
GNA15	G protein subunit alpha 15		landmark		
GNAS	GNAS complex locus	Granins	landmark		
CSK	CSK, non-receptor tyrosine kinase	SH2 domain containing	landmark		
CSNK2A2	casein kinase 2 alpha 2		landmark		
CSNK1E	casein kinase 1 epsilon		landmark		
CSNK1A1	casein kinase 1 alpha 1		landmark		
CSRP1	cysteine and glycine rich protein 1	LIM domain containing	landmark		
SLC35B1	solute carrier family 35 member B1	Solute carriers	landmark		
TIMM17B	translocase of inner mitochondrial membrane 17B		landmark		
KAT6B	lysine acetyltransferase 6B	Zinc fingers C2HC-type, PHD finger proteins, Lysine acetyltransferases	landmark		
NNT	nicotinamide nucleotide transhydrogenase		landmark		
ADAT1	adenosine deaminase, tRNA specific 1	Adenosine deaminases acting on RNA	landmark		
MFSD10	major facilitator superfamily domain containing 10		landmark		
TRIB1	tribbles pseudokinase 1		landmark		
SUZ12	SUZ12 polycomb repressive complex 2 subunit	Zinc fingers C2H2-type, Polycomb repressive complex 2	landmark		
TRIM13	tripartite motif containing 13	Ring finger proteins, Tripartite motif containing	landmark		
TXNDC9	thioredoxin domain containing 9		landmark		
FASTKD5	FAST kinase domains 5		landmark		
SORBS3	sorbin and SH3 domain containing 3		landmark		
RBM6	RNA binding motif protein 6	G-patch domain containing, RNA binding motif containing	landmark		
MACF1	microtubule-actin crosslinking factor 1	EF-hand domain containing, Plakins	landmark		
MBNL2	muscleblind like splicing regulator 2	Zinc fingers CCCH-type	landmark		
ICMT	isoprenylcysteine carboxyl methyltransferase		landmark		
CEBPZ	CCAAT/enhancer binding protein zeta	CCAAT/enhancer binding proteins	landmark		
SFN	stratifin	14-3-3 phospho-serine/phospho-threonine binding proteins	landmark		
SLC25A13	solute carrier family 25 member 13	Solute carriers, EF-hand domain containing	landmark		
GPC1	glypican 1	Glypicans	landmark		
CTNND1	catenin delta 1	Armadillo repeat containing	landmark		
CTSD	cathepsin D	Cathepsins	landmark		
CTSL	cathepsin L	Cathepsins	landmark		
GPER1	G protein-coupled estrogen receptor 1	G protein-coupled estrogen receptor	landmark		
CYB561	cytochrome b561	Cytochrome b561	landmark		
GRB10	growth factor receptor bound protein 10	Pleckstrin homology domain containing, SH2 domain containing	landmark		
GRB7	growth factor receptor bound protein 7	Pleckstrin homology domain containing, SH2 domain containing	landmark		
GRN	granulin precursor		landmark		
TMEM2	transmembrane protein 2		landmark		
HMG20B	high mobility group 20B	Non-canonical high mobility group	landmark		
ARFIP2	ADP ribosylation factor interacting protein 2	Classical BAR domain containing	landmark		
LSM5	LSM5 homolog, U6 small nuclear RNA and mRNA degradation associated		landmark		
PLA2G15	phospholipase A2 group XV	Phospholipases	landmark		
TNIP1	TNFAIP3 interacting protein 1		landmark		
NUP62	nucleoporin 62	Nucleoporins	landmark		
SSBP2	single stranded DNA binding protein 2		landmark		
TMEM5	transmembrane protein 5		landmark		
IKZF1	IKAROS family zinc finger 1	Zinc fingers C2H2-type, Protein phosphatase 1 regulatory subunits	landmark		
NR3C1	nuclear receptor subfamily 3 group C member 1	Nuclear hormone receptors	landmark		
PAK4	p21 (RAC1) activated kinase 4		landmark		
AKAP8	A-kinase anchoring protein 8	A-kinase anchoring proteins	landmark		
STUB1	STIP1 homology and U-box containing protein 1	U-box domain containing, Tetratricopeptide repeat domain containing	landmark		
TMEM50A	transmembrane protein 50A		landmark		
KLHDC2	kelch domain containing 2		landmark		
CXCL2	C-X-C motif chemokine ligand 2	Chemokine ligands, Endogenous ligands	landmark		
NET1	neuroepithelial cell transforming 1	Pleckstrin homology domain containing, Rho guanine nucleotide exchange factors	landmark		
ACOT9	acyl-CoA thioesterase 9	Acyl-CoA thioesterases	landmark		
SMNDC1	survival motor neuron domain containing 1	Tudor domain containing	landmark		
DAG1	dystroglycan 1		landmark		
DAXX	death domain associated protein		landmark		
GSTM2	glutathione S-transferase mu 2	Glutathione S-transferases	landmark		
GSTZ1	glutathione S-transferase zeta 1	Glutathione S-transferases	landmark		
GTF2A2	general transcription factor IIA subunit 2	General transcription factors	landmark		
MSH6	mutS homolog 6	MutS homologs, PWWP domain containing	landmark		
ELAC2	elaC ribonuclease Z 2		landmark		
DCTD	dCMP deaminase		landmark		
DCK	deoxycytidine kinase		landmark		
GTF2E2	general transcription factor IIE subunit 2	General transcription factors	landmark		
DDB2	damage specific DNA binding protein 2	WD repeat domain containing, Xeroderma pigmentosum complementation groups, Nucleotide excision repair	landmark		
GADD45A	growth arrest and DNA damage inducible alpha		landmark		
DECR1	2,4-dienoyl-CoA reductase 1	Short chain dehydrogenase/reductase superfamily	landmark		
DDX10	DEAD-box helicase 10	DEAD-box helicases	landmark		
DFFB	DNA fragmentation factor subunit beta		landmark		
DFFA	DNA fragmentation factor subunit alpha		landmark		
CRTAP	cartilage associated protein		landmark		
VAT1	vesicle amine transport 1		landmark		
STK25	serine/threonine kinase 25	STRIPAK complex	landmark		
LRRC41	leucine rich repeat containing 41		landmark		
VAV3	vav guanine nucleotide exchange factor 3	Pleckstrin homology domain containing, Rho guanine nucleotide exchange factors, SH2 domain containing	landmark		
PPIE	peptidylprolyl isomerase E	RNA binding motif containing, Cyclophilin peptidylprolyl isomerases	landmark		
LYPLA1	lysophospholipase I		landmark		
MYL9	myosin light chain 9	Myosin light chains, EF-hand domain containing	landmark		
DLD	dihydrolipoamide dehydrogenase		landmark		
TUBB6	tubulin beta 6 class V	Tubulins	landmark		
DNM1	dynamin 1	Pleckstrin homology domain containing	landmark		
CIAPIN1	cytokine induced apoptosis inhibitor 1	Seven-beta-strand methyltransferase motif containing	landmark		
DNMT3A	DNA methyltransferase 3 alpha	PWWP domain containing	landmark		
DNMT1	DNA methyltransferase 1	Zinc fingers CXXC-type, Seven-beta-strand methyltransferase motif containing	landmark		
PLSCR3	phospholipid scramblase 3	Phospholipid scramblases	landmark		
TXLNA	taxilin alpha		landmark		
APPBP2	amyloid beta precursor protein binding protein 2		landmark		
HYOU1	hypoxia up-regulated 1	Heat shock 70kDa proteins	landmark		
CHERP	calcium homeostasis endoplasmic reticulum protein	G-patch domain containing	landmark		
SNX6	sorting nexin 6	Sorting nexins, PX-BAR domain containing	landmark		
THAP11	THAP domain containing 11	THAP domain containing	landmark		
DRAP1	DR1 associated protein 1		landmark		
RPP38	ribonuclease P/MRP subunit p38		landmark		
SLC35A1	solute carrier family 35 member A1	Solute carriers	landmark		
MCOLN1	mucolipin 1	Transient receptor potential cation channels	landmark		
DPH2	DPH2 homolog		landmark		
DSG2	desmoglein 2	Desmosomal cadherins	landmark		
TSC22D3	TSC22 domain family member 3		landmark		
DUSP6	dual specificity phosphatase 6	MAP kinase phosphatases	landmark		
DUSP4	dual specificity phosphatase 4	MAP kinase phosphatases	landmark		
DUSP3	dual specificity phosphatase 3	Atypical dual specificity phosphatases	landmark		
PSRC1	proline and serine rich coiled-coil 1		landmark		
TOR1A	torsin family 1 member A		landmark		
E2F2	E2F transcription factor 2	E2F transcription factors	landmark		
ECH1	enoyl-CoA hydratase 1		landmark		
SQRDL	sulfide quinone reductase-like (yeast)		landmark		
LYRM1	LYR motif containing 1	LYR motif containing	landmark		
SCYL3	SCY1 like pseudokinase 3	SCY1 like pseudokinases	landmark		
ENOPH1	enolase-phosphatase 1	HAD Asp-based non-protein phosphatases	landmark		
PRUNE1	prune exopolyphosphatase 1		landmark		
ZMIZ1	zinc finger MIZ-type containing 1	Zinc fingers MIZ-type	landmark		
YKT6	YKT6 v-SNARE homolog (S. cerevisiae)	SNAREs	landmark		
CGRRF1	cell growth regulator with ring finger domain 1	Ring finger proteins	landmark		
NPRL2	NPR2-like, GATOR1 complex subunit	GATOR1 subcomplex	landmark		
IGF2BP2	insulin like growth factor 2 mRNA binding protein 2	RNA binding motif containing	landmark		
STAMBP	STAM binding protein		landmark		
ST6GALNAC2	ST6 N-acetylgalactosaminide alpha-2,6-sialyltransferase 2	Sialyltransferases	landmark		
PAICS	phosphoribosylaminoimidazole carboxylase and phosphoribosylaminoimidazolesuccinocarboxamide synthase		landmark		
CNPY3	canopy FGF signaling regulator 3	Trinucleotide repeat containing	landmark		
RRAGA	Ras related GTP binding A		landmark		
EBP	emopamil binding protein (sterol isomerase)		landmark		
GNB5	G protein subunit beta 5	WD repeat domain containing	landmark		
H2AFV	H2A histone family member V	Histones	landmark		
EDN1	endothelin 1	Endogenous ligands	landmark		
EGF	epidermal growth factor		landmark		
EGR1	early growth response 1	Zinc fingers C2H2-type	landmark		
EGFR	epidermal growth factor receptor	Erb-b2 receptor tyrosine kinases	landmark		
EIF4EBP1	eukaryotic translation initiation factor 4E binding protein 1		landmark		
EIF5	eukaryotic translation initiation factor 5		landmark		
EIF4G1	eukaryotic translation initiation factor 4 gamma 1	Parkinson disease associated genes	landmark		
ELAVL1	ELAV like RNA binding protein 1	RNA binding motif containing	landmark		
MPZL1	myelin protein zero like 1	V-set domain containing	landmark		
SLC25A14	solute carrier family 25 member 14	Solute carriers	landmark		
MAP7	microtubule associated protein 7		landmark		
ADO	2-aminoethanethiol dioxygenase		landmark		
ARPP19	cAMP regulated phosphoprotein 19		landmark		
POP4	POP4 homolog, ribonuclease P/MRP subunit		landmark		
ZNF274	zinc finger protein 274	Zinc fingers C2H2-type, SCAN domain containing	landmark		
ABHD6	abhydrolase domain containing 6	Abhydrolase domain containing	landmark		
DNAJA3	DnaJ heat shock protein family (Hsp40) member A3	DNAJ (HSP40) heat shock proteins	landmark		
USP14	ubiquitin specific peptidase 14	Ubiquitin specific peptidases	landmark		
KDM5B	lysine demethylase 5B	PHD finger proteins, AT-rich interaction domain containing, Lysine demethylases	landmark		
YME1L1	YME1 like 1 ATPase	AAA ATPases	landmark		
TCFL5	transcription factor like 5	Basic helix-loop-helix proteins	landmark		
CASC3	cancer susceptibility 3	Exon junction complex	landmark		
COG2	component of oligomeric golgi complex 2	Components of oligomeric golgi complex	landmark		
MTHFD2	methylenetetrahydrofolate dehydrogenase (NADP+ dependent) 2, methenyltetrahydrofolate cyclohydrolase		landmark		
EML3	echinoderm microtubule associated protein like 3	WD repeat domain containing	landmark		
MTA1	metastasis associated 1	GATA zinc finger domain containing, Myb/SANT domain containing, NuRD complex	landmark		
PDLIM1	PDZ and LIM domain 1	LIM domain containing, PDZ domain containing	landmark		
PRPF4	pre-mRNA processing factor 4	WD repeat domain containing	landmark		
SMC3	structural maintenance of chromosomes 3	Proteoglycans, Structural maintenance of chromosomes proteins, Cohesin complex	landmark		
CCNB2	cyclin B2	Cyclins	landmark		
CCNE2	cyclin E2	Cyclins	landmark		
SYNGR3	synaptogyrin 3		landmark		
LPAR2	lysophosphatidic acid receptor 2	Lysophosphatidic acid receptors	landmark		
ZW10	zw10 kinetochore protein		landmark		
ARHGEF2	Rho/Rac guanine nucleotide exchange factor 2	Pleckstrin homology domain containing, Rho guanine nucleotide exchange factors	landmark		
CPSF4	cleavage and polyadenylation specific factor 4		landmark		
MALT1	MALT1 paracaspase	Immunoglobulin like domain containing, CBM complex	landmark		
KIAA0907	KIAA0907		landmark		
CLSTN1	calsyntenin 1	Cadherin related	landmark		
FOXJ3	forkhead box J3	Forkhead boxes	landmark		
PGRMC1	progesterone receptor membrane component 1	Membrane associated progesterone receptor family	landmark		
CANT1	calcium activated nucleotidase 1		landmark		
RAB11FIP2	RAB11 family interacting protein 2	C2 domain containing	landmark		
ATF5	activating transcription factor 5	Basic leucine zipper proteins	landmark		
MTF2	metal response element binding transcription factor 2	PHD finger proteins, Tudor domain containing	landmark		
PUF60	poly(U) binding splicing factor 60	RNA binding motif containing	landmark		
CLPX	caseinolytic mitochondrial matrix peptidase chaperone subunit	AAA ATPases	landmark		
AURKB	aurora kinase B	Protein phosphatase 1 regulatory subunits, Chromosomal passenger complex	landmark		
VAPB	VAMP associated protein B and C		landmark		
NOLC1	nucleolar and coiled-body phosphoprotein 1		landmark		
WASF3	WAS protein family member 3	Wiskott-Aldrich Syndrome protein family	landmark		
UTP14A	UTP14A small subunit processome component		landmark		
FRS2	fibroblast growth factor receptor substrate 2		landmark		
GRWD1	glutamate rich WD repeat containing 1	WD repeat domain containing	landmark		
UBE2L6	ubiquitin conjugating enzyme E2 L6	Ubiquitin conjugating enzymes E2	landmark		
CYTH1	cytohesin 1	Pleckstrin homology domain containing	landmark		
MAPKAPK2	mitogen-activated protein kinase-activated protein kinase 2	Mitogen-activated protein kinase-activated protein kinases	landmark		
COPB2	coatomer protein complex subunit beta 2	WD repeat domain containing	landmark		
ITGB1BP1	integrin subunit beta 1 binding protein 1		landmark		
BCL7B	BCL tumor suppressor 7B		landmark		
ADGRG1	adhesion G protein-coupled receptor G1	Adhesion G protein-coupled receptors, subfamily G	landmark		
HERC6	HECT and RLD domain containing E3 ubiquitin protein ligase family member 6		landmark		
TMED10	transmembrane p24 trafficking protein 10	Transmembrane p24 trafficking proteins	landmark		
ASCC3	activating signal cointegrator 1 complex subunit 3	DNA helicases, RNA helicases	landmark		
PPP2R3C	protein phosphatase 2 regulatory subunit B''gamma	Protein phosphatase 2 regulatory subunits	landmark		
PIH1D1	PIH1 domain containing 1	R2TP complex	landmark		
RPIA	ribose 5-phosphate isomerase A		landmark		
PDIA5	protein disulfide isomerase family A member 5	Protein disulfide isomerases	landmark		
TOMM34	translocase of outer mitochondrial membrane 34	Tetratricopeptide repeat domain containing	landmark		
FKBP14	FK506 binding protein 14	EF-hand domain containing, FKBP prolyl isomerases	landmark		
EBNA1BP2	EBNA1 binding protein 2		landmark		
CDCA4	cell division cycle associated 4		landmark		
MLLT11	myeloid/lymphoid or mixed-lineage leukemia; translocated to, 11		landmark		
WIPF2	WAS/WASL interacting protein family member 2		landmark		
SACM1L	SAC1 suppressor of actin mutations 1-like (yeast)	Phosphoinositide phosphatases	landmark		
ATF6	activating transcription factor 6	Basic leucine zipper proteins	landmark		
TCERG1	transcription elongation regulator 1		landmark		
TM9SF2	transmembrane 9 superfamily member 2	Transmembrane 9 superfamily members	landmark		
EPN2	epsin 2		landmark		
RNPS1	RNA binding protein with serine rich domain 1	RNA binding motif containing, ASAP complex	landmark		
PDHX	pyruvate dehydrogenase complex component X		landmark		
FOSL1	FOS like 1, AP-1 transcription factor subunit	Basic leucine zipper proteins, Fos transcription factor family	landmark		
BLCAP	bladder cancer associated protein		landmark		
HMGA2	high mobility group AT-hook 2	Canonical high mobility group	landmark		
TRIB3	tribbles pseudokinase 3		landmark		
PLEKHJ1	pleckstrin homology domain containing J1	Pleckstrin homology domain containing	landmark		
HEATR1	HEAT repeat containing 1	Minor histocompatibility antigens	landmark		
ANO10	anoctamin 10	Anoctamins	landmark		
UBR7	ubiquitin protein ligase E3 component n-recognin 7 (putative)	Ubiquitin protein ligase E3 component n-recognins	landmark		
TRAPPC6A	trafficking protein particle complex 6A	Trafficking protein particle complex	landmark		
CHAC1	ChaC glutathione specific gamma-glutamylcyclotransferase 1		landmark		
CCDC86	coiled-coil domain containing 86		landmark		
MAP4K4	mitogen-activated protein kinase kinase kinase kinase 4	Mitogen-activated protein kinase kinase kinase kinases	landmark		
HOMER2	homer scaffolding protein 2	Homer scaffolding proteins	landmark		
SH3BP5	SH3 domain binding protein 5		landmark		
METRN	meteorin, glial cell differentiation regulator		landmark		
PIGB	phosphatidylinositol glycan anchor biosynthesis class B	Dolichyl D-mannosyl phosphate dependent mannosyltransferases, Phosphatidylinositol glycan anchor biosynthesis	landmark		
PSMF1	proteasome inhibitor subunit 1	Proteasome	landmark		
ELOVL6	ELOVL fatty acid elongase 6		landmark		
TMEM109	transmembrane protein 109		landmark		
ITFG1	integrin alpha FG-GAP repeat containing 1		landmark		
FBXO11	F-box protein 11	F-boxes other, Ubiquitin protein ligase E3 component n-recognins	landmark		
ADI1	acireductone dioxygenase 1		landmark		
CCDC92	coiled-coil domain containing 92		landmark		
GDPD5	glycerophosphodiester phosphodiesterase domain containing 5		landmark		
POLD4	DNA polymerase delta 4, accessory subunit	DNA polymerases	landmark		
SPTLC2	serine palmitoyltransferase long chain base subunit 2		landmark		
TBPL1	TATA-box binding protein like 1		landmark		
BAG3	BCL2 associated athanogene 3	BCL2 associated athanogene family	landmark		
NRIP1	nuclear receptor interacting protein 1		landmark		
NCOA3	nuclear receptor coactivator 3	Basic helix-loop-helix proteins, Lysine acetyltransferases, Trinucleotide repeat containing	landmark		
POLR1C	RNA polymerase I subunit C	RNA polymerase subunits	landmark		
SPAG7	sperm associated antigen 7		landmark		
SMC1A	structural maintenance of chromosomes 1A	Structural maintenance of chromosomes proteins, Cohesin complex	landmark		
FAIM	Fas apoptotic inhibitory molecule		landmark		
LAGE3	L antigen family member 3		landmark		
MBOAT7	membrane bound O-acyltransferase domain containing 7	Membrane bound O-acyltransferases	landmark		
PRR15L	proline rich 15 like		landmark		
CRELD2	cysteine rich with EGF like domains 2		landmark		
MAPK1IP1L	mitogen-activated protein kinase 1 interacting protein 1 like		landmark		
FSD1	fibronectin type III and SPRY domain containing 1	Fibronectin type III domain containing	landmark		
NPDC1	neural proliferation, differentiation and control 1		landmark		
ABCF3	ATP binding cassette subfamily F member 3	ATP binding cassette subfamily F	landmark		
ERO1A	endoplasmic reticulum oxidoreductase 1 alpha		landmark		
TRAK2	trafficking kinesin protein 2		landmark		
COASY	Coenzyme A synthase		landmark		
CHMP4A	charged multivesicular body protein 4A	Charged multivesicular body proteins, ESCRT-III	landmark		
GTPBP8	GTP binding protein 8 (putative)		landmark		
IKBKE	inhibitor of nuclear factor kappa B kinase subunit epsilon		landmark		
AXIN1	axin 1	Protein phosphatase 1 regulatory subunits	landmark		
FEZ2	fasciculation and elongation protein zeta 2		landmark		
FZD1	frizzled class receptor 1	G protein-coupled receptors, Class F frizzled	landmark		
HS2ST1	heparan sulfate 2-O-sulfotransferase 1	Sulfotransferases, membrane bound	landmark		
MTFR1	mitochondrial fission regulator 1		landmark		
FZD7	frizzled class receptor 7	G protein-coupled receptors, Class F frizzled	landmark		
CDC45	cell division cycle 45		landmark		
TERT	telomerase reverse transcriptase		landmark		
TESK1	testis-specific kinase 1		landmark		
IPO13	importin 13	Importins	landmark		
VGLL4	vestigial like family member 4	Vestigial like family	landmark		
TFDP1	transcription factor Dp-1	Transcription factor Dp family	landmark		
NUP93	nucleoporin 93	Nucleoporins	landmark		
TFAP2A	transcription factor AP-2 alpha		landmark		
HIST2H2BE	histone cluster 2 H2B family member e	Histones	landmark		
TRAM2	translocation associated membrane protein 2	TLC domain containing	landmark		
EDEM1	ER degradation enhancing alpha-mannosidase like protein 1		landmark		
UBE3C	ubiquitin protein ligase E3C		landmark		
TGFB3	transforming growth factor beta 3	Endogenous ligands	landmark		
TGFBR2	transforming growth factor beta receptor 2	Type 2 receptor serine/threonine kinases	landmark		
PIP4K2B	phosphatidylinositol-5-phosphate 4-kinase type 2 beta		landmark		
TIMP2	TIMP metallopeptidase inhibitor 2	Tissue inhibitor of metallopeptidases	landmark		
TIAM1	T-cell lymphoma invasion and metastasis 1	Pleckstrin homology domain containing, Rho guanine nucleotide exchange factors, PDZ domain containing	landmark		
TLE1	transducin like enhancer of split 1	WD repeat domain containing	landmark		
TJP1	tight junction protein 1	Membrane associated guanylate kinases, PDZ domain containing	landmark		
TBC1D31	TBC1 domain family member 31	WD repeat domain containing	landmark		
TLR4	toll like receptor 4	CD molecules, Toll like receptors	landmark		
DNAJC15	DnaJ heat shock protein family (Hsp40) member C15	DNAJ (HSP40) heat shock proteins	landmark		
TICAM1	toll like receptor adaptor molecule 1	TIR domain containing	landmark		
USP6NL	USP6 N-terminal like		landmark		
KIAA0355	KIAA0355		landmark		
CEP57	centrosomal protein 57		landmark		
KIAA0100	KIAA0100		landmark		
HERPUD1	homocysteine inducible ER protein with ubiquitin like domain 1		landmark		
ADAM10	ADAM metallopeptidase domain 10	ADAM metallopeptidase domain containing, CD molecules	landmark		
CCP110	centriolar coiled-coil protein 110		landmark		
ADH5	alcohol dehydrogenase 5 (class III), chi polypeptide	Alcohol dehydrogenases	landmark		
MLEC	malectin	Oligosaccharyltransferase complex subunits	landmark		
TSPAN6	tetraspanin 6	Tetraspanins	landmark		
NCK2	NCK adaptor protein 2	SH2 domain containing	landmark		
DUSP11	dual specificity phosphatase 11	Atypical dual specificity phosphatases	landmark		
DYRK3	dual specificity tyrosine phosphorylation regulated kinase 3		landmark		
PARP1	poly(ADP-ribose) polymerase 1	Zinc fingers, Zinc fingers PARP-type, Poly(ADP-ribose) polymerases	landmark		
TSPAN4	tetraspanin 4	Tetraspanins	landmark		
ADRB2	adrenoceptor beta 2	Adrenoceptors	landmark		
TATDN2	TatD DNase domain containing 2		landmark		
AGL	amylo-alpha-1, 6-glucosidase, 4-alpha-glucanotransferase		landmark		
TOP2A	topoisomerase (DNA) II alpha	Topoisomerases	landmark		
TP53BP1	tumor protein p53 binding protein 1	Tudor domain containing	landmark		
TP53	tumor protein p53		landmark		
TP53BP2	tumor protein p53 binding protein 2	Ankyrin repeat domain containing, Protein phosphatase 1 regulatory subunits	landmark		
RAE1	ribonucleic acid export 1	WD repeat domain containing, Nucleoporins	landmark		
TPD52L2	tumor protein D52 like 2		landmark		
TPM1	tropomyosin 1 (alpha)	Tropomyosins	landmark		
WDR61	WD repeat domain 61	WD repeat domain containing, Paf1/RNA polymerase II complex 	landmark		
MRPL19	mitochondrial ribosomal protein L19	Mitochondrial ribosomal proteins	landmark		
SCRN1	secernin 1		landmark		
EFCAB14	EF-hand calcium binding domain 14	EF-hand domain containing	landmark		
KEAP1	kelch like ECH associated protein 1	Kelch like, BTB domain containing	landmark		
MELK	maternal embryonic leucine zipper kinase		landmark		
AKT1	AKT serine/threonine kinase 1	Pleckstrin homology domain containing	landmark		
CYCS	cytochrome c, somatic		landmark		
PLEKHM1	pleckstrin homology and RUN domain containing M1	Pleckstrin homology domain containing	landmark		
ALAS1	5'-aminolevulinate synthase 1		landmark		
PIK3R3	phosphoinositide-3-kinase regulatory subunit 3	SH2 domain containing	landmark		
NIPSNAP1	nipsnap homolog 1		landmark		
HAT1	histone acetyltransferase 1	Lysine acetyltransferases	landmark		
KIAA0753	KIAA0753		landmark		
C2CD2L	C2CD2 like		landmark		
ENOSF1	enolase superfamily member 1		landmark		
ALDOA	aldolase, fructose-bisphosphate A		landmark		
C2CD5	C2 calcium dependent domain containing 5	C2 domain containing	landmark		
TM9SF3	transmembrane 9 superfamily member 3	Transmembrane 9 superfamily members	landmark		
IKBKAP	inhibitor of kappa light polypeptide gene enhancer in B-cells, kinase complex-associated protein	Elongator acetyltransferase complex	landmark		
ALDOC	aldolase, fructose-bisphosphate C		landmark		
TOMM70	translocase of outer mitochondrial membrane 70	Tetratricopeptide repeat domain containing, Translocase of outer mitochondrial membrane complex	landmark		
BHLHE40	basic helix-loop-helix family member e40	Basic helix-loop-helix proteins	landmark		
MAPKAPK5	mitogen-activated protein kinase-activated protein kinase 5	Mitogen-activated protein kinase-activated protein kinases	landmark		
WASHC5	WASH complex subunit 5	WASH complex	landmark		
AKR7A2	aldo-keto reductase family 7 member A2	Aldo-keto reductases	landmark		
CASK	calcium/calmodulin dependent serine protein kinase	Trinucleotide repeat containing, Membrane associated guanylate kinases, PDZ domain containing	landmark		
MKNK1	MAP kinase interacting serine/threonine kinase 1	Mitogen-activated protein kinase-activated protein kinases	landmark		
TSTA3	tissue specific transplantation antigen P35B	Short chain dehydrogenase/reductase superfamily	landmark		
SLC25A4	solute carrier family 25 member 4	Solute carriers	landmark		
SLC25A46	solute carrier family 25 member 46	Solute carriers	landmark		
TXNRD1	thioredoxin reductase 1	Selenoproteins	landmark		
CHMP6	charged multivesicular body protein 6	Charged multivesicular body proteins, ESCRT-III	landmark		
IARS2	isoleucyl-tRNA synthetase 2, mitochondrial	Aminoacyl tRNA synthetases, Class I	landmark		
TERF2IP	TERF2 interacting protein	Shelterin complex	landmark		
ACD	ACD, shelterin complex subunit and telomerase recruitment factor	Shelterin complex	landmark		
CARMIL1	capping protein regulator and myosin 1 linker 1		landmark		
ANKRD10	ankyrin repeat domain 10	Ankyrin repeat domain containing	landmark		
DUSP22	dual specificity phosphatase 22	Atypical dual specificity phosphatases	landmark		
KLHL21	kelch like family member 21	Kelch like, BTB domain containing	landmark		
STAP2	signal transducing adaptor family member 2		landmark		
FAM20B	FAM20B, glycosaminoglycan xylosylkinase		landmark		
NCAPD2	non-SMC condensin I complex subunit D2		landmark		
ARNT2	aryl hydrocarbon receptor nuclear translocator 2	Basic helix-loop-helix proteins	landmark		
PAN2	PAN2 poly(A) specific ribonuclease subunit	Ubiquitin specific peptidases, Exonucleases	landmark		
KIF14	kinesin family member 14	Kinesins	landmark		
LPGAT1	lysophosphatidylglycerol acyltransferase 1		landmark		
OXSR1	oxidative stress responsive 1		landmark		
ANXA7	annexin A7	Annexins	landmark		
RUVBL1	RuvB like AAA ATPase 1	AAA ATPases, INO80 complex, DNA helicases, SRCAP complex, R2TP complex	landmark		
APBB2	amyloid beta precursor protein binding family B member 2		landmark		
TCTN1	tectonic family member 1	Tectonic proteins	landmark		
BIRC2	baculoviral IAP repeat containing 2	Ring finger proteins, Baculoviral IAP repeat containing, Caspase recruitment domain containing	landmark		
MVP	major vault protein		landmark		
BIRC5	baculoviral IAP repeat containing 5	Baculoviral IAP repeat containing, Chromosomal passenger complex	landmark		
COQ8A	coenzyme Q8A		landmark		
PSMG1	proteasome assembly chaperone 1		landmark		
APOE	apolipoprotein E	Apolipoproteins	landmark		
APP	amyloid beta precursor protein	Endogenous ligands	landmark		
FAS	Fas cell surface death receptor	CD molecules, Tumor necrosis factor receptor superfamily, Death inducing signaling complex 	landmark		
UBE2A	ubiquitin conjugating enzyme E2 A	Ubiquitin conjugating enzymes E2	landmark		
DMTF1	cyclin D binding myb like transcription factor 1	Myb/SANT domain containing	landmark		
BECN1	beclin 1	Autophagy related	landmark		
RHEB	Ras homolog enriched in brain	RAS type GTPase family	landmark		
UGDH	UDP-glucose 6-dehydrogenase		landmark		
RHOA	ras homolog family member A	Rho family GTPases	landmark		
ARHGAP1	Rho GTPase activating protein 1	Rho GTPase activating proteins, BCH domain containing 	landmark		
NR1H2	nuclear receptor subfamily 1 group H member 2	Nuclear hormone receptors	landmark		
RNH1	ribonuclease/angiogenin inhibitor 1		landmark		
USP1	ubiquitin specific peptidase 1	Ubiquitin specific peptidases	landmark		
PAK6	p21 (RAC1) activated kinase 6		landmark		
INTS3	integrator complex subunit 3	Integrator complex	landmark		
PRR7	proline rich 7, synaptic		landmark		
TMEM110	transmembrane protein 110		landmark		
TSEN2	tRNA splicing endonuclease subunit 2	tRNA-splicing endonuclease subunits	landmark		
TMCO1	transmembrane and coiled-coil domains 1		landmark		
CNDP2	CNDP dipeptidase 2 (metallopeptidase M20 family)		landmark		
NUP133	nucleoporin 133	Minor histocompatibility antigens, Nucleoporins	landmark		
NPEPL1	aminopeptidase-like 1	Aminopeptidases	landmark		
MBTPS1	membrane bound transcription factor peptidase, site 1	Proprotein convertase subtilisin/kexin family	landmark		
ASAH1	N-acylsphingosine amidohydrolase 1		landmark		
RNMT	RNA guanine-7 methyltransferase	Seven-beta-strand methyltransferase motif containing	landmark		
EED	embryonic ectoderm development	WD repeat domain containing, Polycomb repressive complex 2	landmark		
GFOD1	glucose-fructose oxidoreductase domain containing 1		landmark		
CTNNAL1	catenin alpha like 1		landmark		
KCTD5	potassium channel tetramerization domain containing 5		landmark		
VDAC1	voltage dependent anion channel 1	Voltage dependent anion channels	landmark		
MINDY1	MINDY lysine 48 deubiquitinase 1	MINDY deubiquitinases	landmark		
ATF1	activating transcription factor 1	Basic leucine zipper proteins	landmark		
ATP1B1	ATPase Na+/K+ transporting subunit beta 1	ATPase Na+/K+ transporting subunits	landmark		
RPA1	replication protein A1	Nucleotide excision repair	landmark		
RPA3	replication protein A3	Nucleotide excision repair	landmark		
RPA2	replication protein A2	Nucleotide excision repair	landmark		
WFS1	wolframin ER transmembrane glycoprotein		landmark		
WRB	tryptophan rich basic protein		landmark		
XBP1	X-box binding protein 1	Basic leucine zipper proteins	landmark		
MRPL12	mitochondrial ribosomal protein L12	Mitochondrial ribosomal proteins	landmark		
RPN1	ribophorin I	Oligosaccharyltransferase complex subunits	landmark		
RPS5	ribosomal protein S5	S ribosomal proteins	landmark		
RPS6KA1	ribosomal protein S6 kinase A1	Mitogen-activated protein kinase-activated protein kinases	landmark		
RPS6	ribosomal protein S6	S ribosomal proteins	landmark		
FAM69A	family with sequence similarity 69 member A		landmark		
ALDH7A1	aldehyde dehydrogenase 7 family member A1	Aldehyde dehydrogenases	landmark		
EXOSC4	exosome component 4	Exosome complex	landmark		
CISD1	CDGSH iron sulfur domain 1	CDGSH iron sulfur domain containing	landmark		
PEX11A	peroxisomal biogenesis factor 11 alpha	Peroxins	landmark		
CREG1	cellular repressor of E1A stimulated genes 1		landmark		
INPP4B	inositol polyphosphate-4-phosphatase type II B	C2 domain containing, Phosphoinositide phosphatases	landmark		
ATP6V0B	ATPase H+ transporting V0 subunit b	V-type ATPases	landmark		
IQGAP1	IQ motif containing GTPase activating protein 1		landmark		
XPNPEP1	X-prolyl aminopeptidase 1	Aminopeptidases	landmark		
DDIT4	DNA damage inducible transcript 4		landmark		
SOCS2	suppressor of cytokine signaling 2	SH2 domain containing, Suppressors of cytokine signaling	landmark		
CFLAR	CASP8 and FADD like apoptosis regulator	Endogenous ligands, Death effector domain containing, Death inducing signaling complex 	landmark		
CDK5R1	cyclin dependent kinase 5 regulatory subunit 1		landmark		
FAM57A	family with sequence similarity 57 member A	TLC domain containing	landmark		
ZNF395	zinc finger protein 395	Zinc fingers C2H2-type	landmark		
IER3	immediate early response 3		landmark		
BAD	BCL2 associated agonist of cell death	BCL2 homology region 3 (BH3) only	landmark		
ST3GAL5	ST3 beta-galactoside alpha-2,3-sialyltransferase 5	Sialyltransferases	landmark		
ZFP36	ZFP36 ring finger protein	Ring finger proteins	landmark		
SLC5A6	solute carrier family 5 member 6	Solute carriers	landmark		
BAX	BCL2 associated X, apoptosis regulator	BCL2 family	landmark		
SQSTM1	sequestosome 1	Zinc fingers ZZ-type	landmark		
CPNE3	copine 3	Copines	landmark		
CCND1	cyclin D1	Cyclins	landmark		
BCL2	BCL2, apoptosis regulator	Protein phosphatase 1 regulatory subunits, BCL2 family	landmark		
RSU1	Ras suppressor protein 1		landmark		
RTN2	reticulon 2		landmark		
S100A4	S100 calcium binding protein A4	S100 calcium binding proteins, EF-hand domain containing	landmark		
S100A13	S100 calcium binding protein A13	S100 calcium binding proteins	landmark		
KDM3A	lysine demethylase 3A	Lysine demethylases	landmark		
PECR	peroxisomal trans-2-enoyl-CoA reductase	Short chain dehydrogenase/reductase superfamily	landmark		
DHX29	DExH-box helicase 29	DEAH-box helicases	landmark		
EAPP	E2F associated phosphoprotein		landmark		
TRAPPC3	trafficking protein particle complex 3	Trafficking protein particle complex	landmark		
RBKS	ribokinase		landmark		
CCNA1	cyclin A1	Cyclins	landmark		
ATP2C1	ATPase secretory pathway Ca2+ transporting 1	ATPases Ca2+ transporting	landmark		
BDH1	3-hydroxybutyrate dehydrogenase 1	Short chain dehydrogenase/reductase superfamily	landmark		
TIMELESS	timeless circadian clock		landmark		
BID	BH3 interacting domain death agonist	Endogenous ligands, BCL2 homology region 3 (BH3) only	landmark		
BLMH	bleomycin hydrolase		landmark		
BLVRA	biliverdin reductase A		landmark		
TCEAL4	transcription elongation factor A like 4	Transcription elongation factor A like family	landmark		
BMP4	bone morphogenetic protein 4	Bone morphogenetic proteins, Endogenous ligands	landmark		
BNIP3	BCL2 interacting protein 3	BCL2 homology region 3 (BH3) only	landmark		
BNIP3L	BCL2 interacting protein 3 like		landmark		
DHDDS	dehydrodolichyl diphosphate synthase subunit		landmark		
P4HA2	prolyl 4-hydroxylase subunit alpha 2		landmark		
BPHL	biphenyl hydrolase like		landmark		
BRCA1	BRCA1, DNA repair associated	Ring finger proteins, Fanconi anemia complementation groups, Protein phosphatase 1 regulatory subunits, BRCA1 A complex, BRCA1 B complex, BRCA1 C complex	landmark		
NUDT9	nudix hydrolase 9	Nudix hydrolase family	landmark		
SATB1	SATB homeobox 1	CUT class homeoboxes and pseudogenes	landmark		
PLOD3	procollagen-lysine,2-oxoglutarate 5-dioxygenase 3		landmark		
P4HTM	prolyl 4-hydroxylase, transmembrane		landmark		
DENND2D	DENN domain containing 2D	DENN/MADD domain containing	landmark		
NOL3	nucleolar protein 3	Caspase recruitment domain containing	landmark		
BTK	Bruton tyrosine kinase	Pleckstrin homology domain containing, SH2 domain containing	landmark		
SCP2	sterol carrier protein 2		landmark		
CCL2	C-C motif chemokine ligand 2	Chemokine ligands, Endogenous ligands	landmark		
OXA1L	OXA1L, mitochondrial inner membrane protein		landmark		
OXCT1	3-oxoacid CoA-transferase 1		landmark		
ZNF131	zinc finger protein 131	Zinc fingers C2H2-type, BTB domain containing	landmark		
PAFAH1B1	platelet activating factor acetylhydrolase 1b regulatory subunit 1	WD repeat domain containing	landmark		
SERPINE1	serpin family E member 1	Serpin peptidase inhibitors	landmark		
PAK1	p21 (RAC1) activated kinase 1		landmark		
PAFAH1B3	platelet activating factor acetylhydrolase 1b catalytic subunit 3		landmark		
SDHB	succinate dehydrogenase complex iron sulfur subunit B	Mitochondrial complex II: succinate dehydrogenase subunits	landmark		
PCCB	propionyl-CoA carboxylase beta subunit		landmark		
PCBD1	pterin-4 alpha-carbinolamine dehydratase 1		landmark		
NUP85	nucleoporin 85	Nucleoporins	landmark		
PAF1	PAF1 homolog, Paf1/RNA polymerase II complex component	Paf1/RNA polymerase II complex	landmark		
KLHL9	kelch like family member 9	Kelch like, BTB domain containing	landmark		
BUB1B	BUB1 mitotic checkpoint serine/threonine kinase B		landmark		
C5	complement C5	Complement system, Endogenous ligands, C3 and PZP like, alpha-2-macroglobulin domain containing	landmark		
ZMYM2	zinc finger MYM-type containing 2	Zinc fingers MYM-type	landmark		
DDR1	discoidin domain receptor tyrosine kinase 1	Receptor Tyrosine Kinases, CD molecules	landmark		
PCMT1	protein-L-isoaspartate (D-aspartate) O-methyltransferase	Seven-beta-strand methyltransferase motif containing	landmark		
PCNA	proliferating cell nuclear antigen		landmark		
SGCB	sarcoglycan beta		landmark		
PCK2	phosphoenolpyruvate carboxykinase 2, mitochondrial		landmark		
PCM1	pericentriolar material 1		landmark		
SHB	SH2 domain containing adaptor protein B	SH2 domain containing	landmark		
SHC1	SHC adaptor protein 1	SH2 domain containing	landmark		
PDGFA	platelet derived growth factor subunit A		landmark		
SKIV2L	Ski2 like RNA helicase	RNA helicases	landmark		
SLC35F2	solute carrier family 35 member F2	Solute carriers	landmark		
ATP5S	ATP synthase, H+ transporting, mitochondrial Fo complex subunit s (factor B)		landmark		
PACSIN3	protein kinase C and casein kinase substrate in neurons 3	F-BAR domain containing	landmark		
CALM3	calmodulin 3	Endogenous ligands, EF-hand domain containing	landmark		
CALU	calumenin	EF-hand domain containing	landmark		
CAPN1	calpain 1	EF-hand domain containing, Calpains	landmark		
CAST	calpastatin		landmark		
CASP2	caspase 2	Caspases, Protein phosphatase 1 regulatory subunits, Caspase recruitment domain containing	landmark		
CASP3	caspase 3	Caspases	landmark		
CASP7	caspase 7	Caspases	landmark		
CASP10	caspase 10	Caspases, Death effector domain containing, Death inducing signaling complex 	landmark		
CAT	catalase		landmark		
SKP1	S-phase kinase associated protein 1	SCF complex	landmark		
CBLB	Cbl proto-oncogene B	Ring finger proteins	landmark		
SLC1A4	solute carrier family 1 member 4	Solute carriers	landmark		
CBR1	carbonyl reductase 1	Short chain dehydrogenase/reductase superfamily	landmark		
CBR3	carbonyl reductase 3	Short chain dehydrogenase/reductase superfamily	landmark		
CXCR4	C-X-C motif chemokine receptor 4	CD molecules, C-X-C motif chemokine receptors	landmark		
TEX10	testis expressed 10	5FMC ribosome biogenesis complex	landmark		
PAX8	paired box 8	PRD class homeoboxes and pseudogenes, Paired boxes	landmark		
CCNA2	cyclin A2	Cyclins	landmark		
CCNB1	cyclin B1	Cyclins	landmark		
CCND3	cyclin D3	Cyclins	landmark		
CCNF	cyclin F	Cyclins, F-boxes other	landmark		
PFKL	phosphofructokinase, liver type		landmark		
USP7	ubiquitin specific peptidase 7	Ubiquitin specific peptidases	landmark		
IFRD2	interferon related developmental regulator 2		landmark		
MAPKAPK3	mitogen-activated protein kinase-activated protein kinase 3	Mitogen-activated protein kinase-activated protein kinases	landmark		
PGAM1	phosphoglycerate mutase 1	Bisphosphoglycerate phosphatases	landmark		
PGM1	phosphoglucomutase 1		landmark		
PHKA1	phosphorylase kinase regulatory subunit alpha 1		landmark		
PHKB	phosphorylase kinase regulatory subunit beta		landmark		
PHKG2	phosphorylase kinase catalytic subunit gamma 2		landmark		
SMARCA4	SWI/SNF related, matrix associated, actin dependent regulator of chromatin, subfamily a, member 4		landmark		
SMARCC1	SWI/SNF related, matrix associated, actin dependent regulator of chromatin subfamily c member 1	Myb/SANT domain containing	landmark		
ZNF586	zinc finger protein 586	Zinc fingers C2H2-type	landmark		
PIK3C2B	phosphatidylinositol-4-phosphate 3-kinase catalytic subunit type 2 beta	Phosphatidylinositol 3-kinase subunits	landmark		
PIK3C3	phosphatidylinositol 3-kinase catalytic subunit type 3	Phosphatidylinositol 3-kinase subunits	landmark		
PIK3CA	phosphatidylinositol-4,5-bisphosphate 3-kinase catalytic subunit alpha	Phosphatidylinositol 3-kinase subunits	landmark		
FBXL12	F-box and leucine rich repeat protein 12	F-box and leucine rich repeat proteins	landmark		
TNFRSF21	TNF receptor superfamily member 21	CD molecules, Tumor necrosis factor receptor superfamily	landmark		
SESN1	sestrin 1		landmark		
RBM15B	RNA binding motif protein 15B	RNA binding motif containing	landmark		
PIK3R4	phosphoinositide-3-kinase regulatory subunit 4	WD repeat domain containing	landmark		
CCNH	cyclin H	Cyclins	landmark		
DNTTIP2	deoxynucleotidyltransferase terminal interacting protein 2		landmark		
SCCPDH	saccharopine dehydrogenase (putative)		landmark		
SCARB1	scavenger receptor class B member 1	Scavenger receptors	landmark		
REEP5	receptor accessory protein 5	Receptor accessory proteins	landmark		
CD40	CD40 molecule	CD molecules, Tumor necrosis factor receptor superfamily	landmark		
CD44	CD44 molecule (Indian blood group)	Blood group antigens, CD molecules, Proteoglycans	landmark		
CD58	CD58 molecule	CD molecules	landmark		
SENP6	SUMO1/sentrin specific peptidase 6	SUMO specific peptidases	landmark		
ADGRE5	adhesion G protein-coupled receptor E5	CD molecules, Adhesion G protein-coupled receptors, subfamily E	landmark		
SMARCD2	SWI/SNF related, matrix associated, actin dependent regulator of chromatin, subfamily d, member 2		landmark		
RAI14	retinoic acid induced 14	Ankyrin repeat domain containing	landmark		
CDK1	cyclin dependent kinase 1	Cyclin dependent kinases	landmark		
SNAP25	synaptosome associated protein 25	SNAREs	landmark		
PIN1	peptidylprolyl cis/trans isomerase, NIMA-interacting 1	Parvulins	landmark		
CDC20	cell division cycle 20	WD repeat domain containing	landmark		
CDC25A	cell division cycle 25A	Class III Cys-based CDC25 phosphatases	landmark		
CDC25B	cell division cycle 25B	Class III Cys-based CDC25 phosphatases	landmark		
MTERF3	mitochondrial transcription termination factor 3		landmark		
CDC42	cell division cycle 42	Rho family GTPases	landmark		
AMDHD2	amidohydrolase domain containing 2		landmark		
SNCA	synuclein alpha	Parkinson disease associated genes	landmark		
ISOC1	isochorismatase domain containing 1		landmark		
PLA2G4A	phospholipase A2 group IVA	Phospholipases, C2 domain containing phospholipases	landmark		
ST7	suppression of tumorigenicity 7		landmark		
MRPS16	mitochondrial ribosomal protein S16	Mitochondrial ribosomal proteins	landmark		
FIS1	fission, mitochondrial 1	Tetratricopeptide repeat domain containing	landmark		
GOLT1B	golgi transport 1B		landmark		
COG7	component of oligomeric golgi complex 7	Components of oligomeric golgi complex	landmark		
PLCB3	phospholipase C beta 3	Phospholipases, C2 domain containing phospholipases	landmark		
KAT6A	lysine acetyltransferase 6A	Zinc fingers C2HC-type, PHD finger proteins, Lysine acetyltransferases	landmark		
GLOD4	glyoxalase domain containing 4		landmark		
SOX2	SRY-box 2	SRY-boxes	landmark		
SOX4	SRY-box 4	SRY-boxes	landmark		
SPAG4	sperm associated antigen 4		landmark		
PLP2	proteolipid protein 2		landmark		
GMNN	geminin, DNA replication inhibitor		landmark		
LAP3	leucine aminopeptidase 3	Aminopeptidases	landmark		
LOXL1	lysyl oxidase like 1		landmark		
PLK1	polo like kinase 1		landmark		
SPP1	secreted phosphoprotein 1	Endogenous ligands, SIBLING family	landmark		
PMAIP1	phorbol-12-myristate-13-acetate-induced protein 1	BCL2 homology region 3 (BH3) only	landmark		
SPR	sepiapterin reductase (7,8-dihydrobiopterin:NADP+ oxidoreductase)	Short chain dehydrogenase/reductase superfamily	landmark		
PLS1	plastin 1	EF-hand domain containing	landmark		
PLSCR1	phospholipid scramblase 1	Phospholipid scramblases	landmark		
PMM2	phosphomannomutase 2	HAD Asp-based non-protein phosphatases	landmark		
LRPAP1	LDL receptor related protein associated protein 1		landmark		
NOSIP	nitric oxide synthase interacting protein		landmark		
DERA	deoxyribose-phosphate aldolase		landmark		
YTHDF1	YTH N6-methyladenosine RNA binding protein 1		landmark		
LYN	LYN proto-oncogene, Src family tyrosine kinase	SH2 domain containing, Src family tyrosine kinases	landmark		
TIMM22	translocase of inner mitochondrial membrane 22	TIM22 complex	landmark		
SMAD3	SMAD family member 3	SMAD family	landmark		
NENF	neudesin neurotrophic factor	Membrane associated progesterone receptor family	landmark		
TXNL4B	thioredoxin like 4B		landmark		
HOOK2	hook microtubule tethering protein 2		landmark		
SNX11	sorting nexin 11	Sorting nexins	landmark		
ZNF451	zinc finger protein 451	Zinc fingers C2H2-type	landmark		
TMEM97	transmembrane protein 97		landmark		
LRP10	LDL receptor related protein 10	Low density lipoprotein receptors	landmark		
HTATSF1	HIV-1 Tat specific factor 1	RNA binding motif containing	landmark		
RNF167	ring finger protein 167	Ring finger proteins	landmark		
UBQLN2	ubiquilin 2	Ubiquilin family	landmark		
SPTAN1	spectrin alpha, non-erythrocytic 1	EF-hand domain containing, Spectrins	landmark		
SRC	SRC proto-oncogene, non-receptor tyrosine kinase	SH2 domain containing, Src family tyrosine kinases	landmark		
POLB	DNA polymerase beta	DNA polymerases	landmark		
POLE2	DNA polymerase epsilon 2, accessory subunit	DNA polymerases	landmark		
POLR2K	RNA polymerase II subunit K	RNA polymerase subunits	landmark		
STAT1	signal transducer and activator of transcription 1	SH2 domain containing	landmark		
STAT3	signal transducer and activator of transcription 3	SH2 domain containing	landmark		
POLR2I	RNA polymerase II subunit I	RNA polymerase subunits	landmark		
STAT5B	signal transducer and activator of transcription 5B	SH2 domain containing	landmark		
AURKA	aurora kinase A	Protein phosphatase 1 regulatory subunits	landmark		
STK10	serine/threonine kinase 10		landmark		
VPS28	VPS28, ESCRT-I subunit	ESCRT-I	landmark		
MAN2B1	mannosidase alpha class 2B member 1	Mannosidases alpha class 2	landmark		
MAT2A	methionine adenosyltransferase 2A		landmark		
HSD17B11	hydroxysteroid 17-beta dehydrogenase 11	Short chain dehydrogenase/reductase superfamily	landmark		
PPARD	peroxisome proliferator activated receptor delta	Nuclear hormone receptors	landmark		
PPARG	peroxisome proliferator activated receptor gamma	Nuclear hormone receptors	landmark		
MBNL1	muscleblind like splicing regulator 1	Zinc fingers CCCH-type	landmark		
PPIC	peptidylprolyl isomerase C	Cyclophilin peptidylprolyl isomerases	landmark		
PPOX	protoporphyrinogen oxidase		landmark		
MCM3	minichromosome maintenance complex component 3	MCM family	landmark		
ATG3	autophagy related 3	Autophagy related	landmark		
ZDHHC6	zinc finger DHHC-type containing 6	Zinc fingers DHHC-type	landmark		
NARFL	nuclear prelamin A recognition factor like	Cytosolic iron-sulfur assembly components	landmark		
MRPS2	mitochondrial ribosomal protein S2	Mitochondrial ribosomal proteins	landmark		
TES	testin LIM domain protein	LIM domain containing	landmark		
KIF1BP	KIF1 binding protein	Tetratricopeptide repeat domain containing	landmark		
STX1A	syntaxin 1A	Syntaxins	landmark		
STX4	syntaxin 4	Syntaxins	landmark		
STXBP1	syntaxin binding protein 1		landmark		
STXBP2	syntaxin binding protein 2		landmark		
SUV39H1	suppressor of variegation 3-9 homolog 1	Lysine methyltransferases, SET domain containing	landmark		
SUPV3L1	Suv3 like RNA helicase	RNA helicases	landmark		
SYK	spleen associated tyrosine kinase	SH2 domain containing	landmark		
MYCBP	MYC binding protein		landmark		
ME2	malic enzyme 2		landmark		
SYPL1	synaptophysin like 1		landmark		
PPP2R5A	protein phosphatase 2 regulatory subunit B'alpha	Protein phosphatase 2 regulatory subunits	landmark		
PPP2R5E	protein phosphatase 2 regulatory subunit B'epsilon	Protein phosphatase 2 regulatory subunits	landmark		
MEF2C	myocyte enhancer factor 2C	Myocyte enhancer factor 2 proteins, MADS box family	landmark		
MAP3K4	mitogen-activated protein kinase kinase kinase 4	Mitogen-activated protein kinase kinase kinases	landmark		
PRCP	prolylcarboxypeptidase	Minor histocompatibility antigens, Carboxypeptidases	landmark		
TARBP1	TAR (HIV-1) RNA binding protein 1	SPOUT methyltranferase domain containing	landmark		
MEST	mesoderm specific transcript		landmark		
HN1L	hematological and neurological expressed 1 like		landmark		
PRKACA	protein kinase cAMP-activated catalytic subunit alpha		landmark		
PRKCD	protein kinase C delta	C2 domain containing protein kinases	landmark		
PRKCH	protein kinase C eta	C2 domain containing protein kinases	landmark		
SCAND1	SCAN domain containing 1	SCAN domain containing	landmark		
CD320	CD320 molecule	CD molecules	landmark		
PRKCQ	protein kinase C theta	C2 domain containing protein kinases	landmark		
MIF	macrophage migration inhibitory factor (glycosylation-inhibiting factor)		landmark		
NUSAP1	nucleolar and spindle associated protein 1		landmark		
PHGDH	phosphoglycerate dehydrogenase		landmark		
TBP	TATA-box binding protein	General transcription factors	landmark		
TBX2	T-box 2	T-boxes	landmark		
TCEA2	transcription elongation factor A2		landmark		
TBXA2R	thromboxane A2 receptor	Prostaglandin (prostanoid) receptors	landmark		
MAP2K5	mitogen-activated protein kinase kinase 5	Mitogen-activated protein kinase kinases	landmark		
MAPK9	mitogen-activated protein kinase 9	Mitogen-activated protein kinases	landmark		
MAPK13	mitogen-activated protein kinase 13	Mitogen-activated protein kinases	landmark		
VPS72	vacuolar protein sorting 72 homolog	SRCAP complex	landmark		
PRKX	protein kinase, X-linked		landmark		
PROS1	protein S (alpha)	Gla domain containing	landmark		
LGMN	legumain		landmark		
FOXO4	forkhead box O4	Forkhead boxes	landmark		
MMP1	matrix metallopeptidase 1	Endogenous ligands, Matrix metallopeptidases	landmark		
MMP2	matrix metallopeptidase 2	Matrix metallopeptidases	landmark		
DYNLT3	dynein light chain Tctex-type 3	Dyneins, cytoplasmic	landmark		
MNAT1	MNAT1, CDK activating kinase assembly factor	Ring finger proteins, Nucleotide excision repair	landmark		
HTRA1	HtrA serine peptidase 1	Proteases, serine, PDZ domain containing	landmark		
TCTA	T-cell leukemia translocation altered		landmark		
SNX7	sorting nexin 7	Sorting nexins, PX-BAR domain containing	landmark		
ATP6V1D	ATPase H+ transporting V1 subunit D	V-type ATPases	landmark		
ZNF589	zinc finger protein 589	Zinc fingers C2H2-type	landmark		
PSMB8	proteasome subunit beta 8	Proteasome	landmark		
HADH	hydroxyacyl-CoA dehydrogenase		landmark		
HSD17B10	hydroxysteroid 17-beta dehydrogenase 10	X-linked mental retardation, Short chain dehydrogenase/reductase superfamily	landmark		
PSMB10	proteasome subunit beta 10	Proteasome	landmark		
HDAC2	histone deacetylase 2	Histone deacetylases, class I, EMSY complex, NuRD complex, SIN3 histone deacetylase complex	landmark		
HIF1A	hypoxia inducible factor 1 alpha subunit	Basic helix-loop-helix proteins	landmark		
HK1	hexokinase 1		landmark		
UBE3B	ubiquitin protein ligase E3B		landmark		
BZW2	basic leucine zipper and W2 domains 2		landmark		
NGRN	neugrin, neurite outgrowth associated		landmark		
PSMD2	proteasome 26S subunit, non-ATPase 2	Proteasome	landmark		
PSMD4	proteasome 26S subunit, non-ATPase 4	Proteasome	landmark		
PSMD9	proteasome 26S subunit, non-ATPase 9	Proteasome, PDZ domain containing	landmark		
PSMD10	proteasome 26S subunit, non-ATPase 10	Ankyrin repeat domain containing, Proteasome	landmark		
PSME1	proteasome activator subunit 1	Proteasome	landmark		
PSME2	proteasome activator subunit 2	Proteasome	landmark		
PTGS2	prostaglandin-endoperoxide synthase 2		landmark		
PTK2	protein tyrosine kinase 2	Protein phosphatase 1 regulatory subunits, FERM domain containing	landmark		
PTPN1	protein tyrosine phosphatase, non-receptor type 1	Protein tyrosine phosphatases, non-receptor type	landmark		
HLA-DMA	major histocompatibility complex, class II, DM alpha	Histocompatibility complex, C1-set domain containing	landmark		
PTPN12	protein tyrosine phosphatase, non-receptor type 12	Protein tyrosine phosphatases, non-receptor type	landmark		
HLA-DRA	major histocompatibility complex, class II, DR alpha	Histocompatibility complex, C1-set domain containing	landmark		
PTPN6	protein tyrosine phosphatase, non-receptor type 6	SH2 domain containing, Protein tyrosine phosphatases, non-receptor type	landmark		
PTPRF	protein tyrosine phosphatase, receptor type F	Fibronectin type III domain containing, I-set domain containing, Protein tyrosine phosphatases, receptor type	landmark		
PTPRK	protein tyrosine phosphatase, receptor type K	Fibronectin type III domain containing, Immunoglobulin like domain containing, Protein tyrosine phosphatases, receptor type	landmark		
HACD3	3-hydroxyacyl-CoA dehydratase 3		landmark		
PTPRC	protein tyrosine phosphatase, receptor type C	CD molecules, Fibronectin type III domain containing, Protein tyrosine phosphatases, receptor type	landmark		
MSRA	methionine sulfoxide reductase A		landmark		
HMGCR	3-hydroxy-3-methylglutaryl-CoA reductase		landmark		
HMOX1	heme oxygenase 1		landmark		
HMGCS1	3-hydroxy-3-methylglutaryl-CoA synthase 1		landmark		
PRKAG2	protein kinase AMP-activated non-catalytic subunit gamma 2		landmark		
ACBD3	acyl-CoA binding domain containing 3	A-kinase anchoring proteins	landmark		
UBE2J1	ubiquitin conjugating enzyme E2 J1	Ubiquitin conjugating enzymes E2	landmark		
EVL	Enah/Vasp-like	ENAH/VASPs	landmark		
CERK	ceramide kinase		landmark		
PXMP2	peroxisomal membrane protein 2		landmark		
PXN	paxillin	LIM domain containing	landmark		
PYCR1	pyrroline-5-carboxylate reductase 1		landmark		
PYGL	glycogen phosphorylase L	Glycogen phosphorylases	landmark		
RAB27A	RAB27A, member RAS oncogene family	RAB, member RAS oncogene GTPases	landmark		
HOXA10	homeobox A10	HOXL subclass homeoboxes	landmark		
HOXA5	homeobox A5	HOXL subclass homeoboxes	landmark		
RAB4A	RAB4A, member RAS oncogene family	RAB, member RAS oncogene GTPases	landmark		
RAC2	ras-related C3 botulinum toxin substrate 2 (rho family, small GTP binding protein Rac2)	Rho family GTPases, Endogenous ligands	landmark		
RAD9A	RAD9 checkpoint clamp component A	Checkpoint clamp complex	landmark		
MOK	MOK protein kinase		landmark		
RAD51C	RAD51 paralog C	Fanconi anemia complementation groups	landmark		
RALA	RAS like proto-oncogene A	RAS type GTPase family	landmark		
RALB	RAS like proto-oncogene B	RAS type GTPase family	landmark		
MUC1	mucin 1, cell surface associated	CD molecules, Mucins	landmark		
HPRT1	hypoxanthine phosphoribosyltransferase 1		landmark		
HES1	hes family bHLH transcription factor 1	Basic helix-loop-helix proteins	landmark		
CHIC2	cysteine rich hydrophobic domain 2		landmark		
UFM1	ubiquitin fold modifier 1		landmark		
TIMM9	translocase of inner mitochondrial membrane 9	TIM22 complex	landmark		
LSR	lipolysis stimulated lipoprotein receptor	Immunoglobulin like domain containing	landmark		
RAP1GAP	RAP1 GTPase activating protein		landmark		
RALGDS	ral guanine nucleotide dissociation stimulator		landmark		
KDM5A	lysine demethylase 5A	PHD finger proteins, AT-rich interaction domain containing, Lysine demethylases, EMSY complex	landmark		
RASA1	RAS p21 protein activator 1	Pleckstrin homology domain containing, SH2 domain containing, C2 and RasGAP domain containing	landmark		
RB1	RB transcriptional corepressor 1	Endogenous ligands	landmark		
MYC	v-myc avian myelocytomatosis viral oncogene homolog	Basic helix-loop-helix proteins	landmark		
MYBL2	MYB proto-oncogene like 2	Myb/SANT domain containing	landmark		
GADD45B	growth arrest and DNA damage inducible beta		landmark		
RELB	RELB proto-oncogene, NF-kB subunit	NF-kappa B complex subunits	landmark		
HSPA1A	heat shock protein family A (Hsp70) member 1A	Heat shock 70kDa proteins	landmark		
DNAJB2	DnaJ heat shock protein family (Hsp40) member B2	DNAJ (HSP40) heat shock proteins	landmark		
HSPA4	heat shock protein family A (Hsp70) member 4	Heat shock 70kDa proteins	landmark		
MYLK	myosin light chain kinase	Fibronectin type III domain containing, I-set domain containing	landmark		
MYO10	myosin X	Pleckstrin homology domain containing, Myosins, class X, FERM domain containing	landmark		
RFC2	replication factor C subunit 2	AAA ATPases	landmark		
HSPB1	heat shock protein family B (small) member 1	Small heat shock proteins	landmark		
HSPA8	heat shock protein family A (Hsp70) member 8	Heat shock 70kDa proteins, NineTeen complex	landmark		
RFX5	regulatory factor X5	Regulatory factor X family	landmark		
HSPD1	heat shock protein family D (Hsp60) member 1	Chaperonins	landmark		
RFC5	replication factor C subunit 5	AAA ATPases	landmark		
RFNG	RFNG O-fucosylpeptide 3-beta-N-acetylglucosaminyltransferase	Beta 3-glycosyltransferases	landmark		
DNAJB1	DnaJ heat shock protein family (Hsp40) member B1	DNAJ (HSP40) heat shock proteins	landmark		
RGS2	regulator of G-protein signaling 2	Endogenous ligands, Regulators of G-protein signaling	landmark		
CTTN	cortactin		landmark		
NCK1	NCK adaptor protein 1	SH2 domain containing	landmark		
EPHA3	EPH receptor A3	Fibronectin type III domain containing, Sterile alpha motif domain containing, EPH receptors	landmark		
EPB41L2	erythrocyte membrane protein band 4.1 like 2	Erythrocyte membrane protein band 4.1, FERM domain containing	landmark		
ICAM3	intercellular adhesion molecule 3	CD molecules, Immunoglobulin like domain containing	landmark		
ICAM1	intercellular adhesion molecule 1	CD molecules, Endogenous ligands, Immunoglobulin like domain containing	landmark		
EPHB2	EPH receptor B2	Fibronectin type III domain containing, Sterile alpha motif domain containing, EPH receptors	landmark		
ID2	inhibitor of DNA binding 2, HLH protein	Basic helix-loop-helix proteins	landmark		
ERBB3	erb-b2 receptor tyrosine kinase 3	Erb-b2 receptor tyrosine kinases	landmark		
ERBB2	erb-b2 receptor tyrosine kinase 2	CD molecules, Minor histocompatibility antigens, Erb-b2 receptor tyrosine kinases	landmark		
NR2F6	nuclear receptor subfamily 2 group F member 6	Nuclear hormone receptors	landmark		
EPRS	glutamyl-prolyl-tRNA synthetase	Aminoacyl tRNA synthetases, Class I, Aminoacyl tRNA synthetases, Class II	landmark		
NT5DC2	5'-nucleotidase domain containing 2		landmark		
DHRS7	dehydrogenase/reductase 7	Short chain dehydrogenase/reductase superfamily	landmark		
IDE	insulin degrading enzyme		landmark		
ETFB	electron transfer flavoprotein beta subunit		landmark		
NFE2L2	nuclear factor, erythroid 2 like 2	Basic leucine zipper proteins	landmark		
NFIL3	nuclear factor, interleukin 3 regulated	Basic leucine zipper proteins	landmark		
ETV1	ETS variant 1	ETS transcription factor family	landmark		
ETS1	ETS proto-oncogene 1, transcription factor	ETS transcription factor family	landmark		
NFATC3	nuclear factor of activated T-cells 3	Nuclear factors of activated T-cells	landmark		
NFATC4	nuclear factor of activated T-cells 4	Nuclear factors of activated T-cells	landmark		
NFKB2	nuclear factor kappa B subunit 2	Ankyrin repeat domain containing, NF-kappa B complex subunits	landmark		
NFKBIA	NFKB inhibitor alpha	Ankyrin repeat domain containing	landmark		
NFKBIB	NFKB inhibitor beta	Ankyrin repeat domain containing	landmark		
NFKBIE	NFKB inhibitor epsilon	Ankyrin repeat domain containing	landmark		
EXT1	exostosin glycosyltransferase 1	Exostosin glycosyltransferase family	landmark		
IFNAR1	interferon alpha and beta receptor subunit 1	Interferon receptors	landmark		
IGFBP3	insulin like growth factor binding protein 3	Insulin like growth factor binding proteins	landmark		
IGF2R	insulin like growth factor 2 receptor	CD molecules, MRH domain containing 	landmark		
IGF1R	insulin like growth factor 1 receptor	Receptor Tyrosine Kinases, CD molecules, Fibronectin type III domain containing	landmark		
EZH2	enhancer of zeste 2 polycomb repressive complex 2 subunit	Lysine methyltransferases, Myb/SANT domain containing, Polycomb repressive complex 2, SET domain containing	landmark		
PTK2B	protein tyrosine kinase 2 beta	Minor histocompatibility antigens, FERM domain containing	landmark		
FAH	fumarylacetoacetate hydrolase		landmark		
FAT1	FAT atypical cadherin 1	Cadherin related	landmark		
ZNF318	zinc finger protein 318	Zinc fingers C2H2-type	landmark		
CAB39	calcium binding protein 39		landmark		
NIT1	nitrilase 1		landmark		
ARID4B	AT-rich interaction domain 4B	AT-rich interaction domain containing	landmark		
IGHMBP2	immunoglobulin mu binding protein 2	Zinc fingers AN1-type, UPF1 like RNA helicases	landmark		
NMT1	N-myristoyltransferase 1		landmark		
CNOT4	CCR4-NOT transcription complex subunit 4	RNA binding motif containing, CCR4-NOT transcription complex	landmark		
NOS3	nitric oxide synthase 3		landmark		
PNP	purine nucleoside phosphorylase		landmark		
NOTCH1	notch 1	Ankyrin repeat domain containing	landmark		
NPC1	NPC intracellular cholesterol transporter 1		landmark		
IKBKB	inhibitor of nuclear factor kappa B kinase subunit beta		landmark		
SLC11A2	solute carrier family 11 member 2	Solute carriers	landmark		
NRAS	neuroblastoma RAS viral oncogene homolog	RAS type GTPase family	landmark		
FDFT1	farnesyl-diphosphate farnesyltransferase 1		landmark		
IL1B	interleukin 1 beta	Endogenous ligands, Interleukins	landmark		
IL4R	interleukin 4 receptor	CD molecules, Interleukin receptors	landmark		
FGFR4	fibroblast growth factor receptor 4	Receptor Tyrosine Kinases, CD molecules, I-set domain containing	landmark		
FGFR2	fibroblast growth factor receptor 2	Receptor Tyrosine Kinases, CD molecules, I-set domain containing	landmark		
FHL2	four and a half LIM domains 2	LIM domain containing	landmark		
IL13RA1	interleukin 13 receptor subunit alpha 1	CD molecules, Interleukin receptors	landmark		
FKBP4	FK506 binding protein 4	Tetratricopeptide repeat domain containing, FKBP prolyl isomerases	landmark		
ABHD4	abhydrolase domain containing 4	Abhydrolase domain containing	landmark		
HIST1H2BK	histone cluster 1 H2B family member k	Histones	landmark		
NUCB2	nucleobindin 2	EF-hand domain containing	landmark		
NUP88	nucleoporin 88	Nucleoporins	landmark		
NVL	nuclear VCP-like	AAA ATPases	landmark		
ILK	integrin linked kinase	Ankyrin repeat domain containing	landmark		
INPP1	inositol polyphosphate-1-phosphatase	Phosphoinositide phosphatases	landmark		
